--------------------
| |   |       |     |
| +-+-+ +-+-+ + +-+ +
|     |   | | |   | |
|-+-+-+-+ + + +-+ + +
|   |     | |     | |
| +-+ +-+ + +-+-+-+ +
|     |   | |     | |
| +-+-+ + + + +-+ + +
|   |   | | | |   | |
|-+ + +-+-+ +-+ + + +
| | | |     |   | | |
| + +-+-+ +-+ +-+-+ +
| | | |     | |     |
| + + + +-+ + + +-+-+
| | | | |   | | |   |
| + + +-+-+ + + + +-+
| | | |     |   |   |
|-+ +-+ +-+-+ +-+ +-+
|       |           |
|-+-+-+-+-+-+-+-+-+-+