--------------------
|     |     |   |   |
| + +-+ +-+ + + + + +
| |     |   | |   | |
| + +-+-+ + + +-+-+ +
| |   |   |   | |   |
| + + +-+-+-+-+ + +-+
|   |   | | |   |   |
|-+ + +-+ + + + +-+ +
| | | | |     | |   |
| +-+-+ + +-+ + + +-+
|   | |     | |     |
|-+ + + +-+ + +-+-+-+
|       |   |       |
| +-+-+ + +-+-+-+-+ +
|     | | | |     | |
|-+ +-+-+ + + + + + +
| |     | |   | |   |
| +-+ +-+ + + +-+-+-+
|     |   | |       |
|-+-+-+-+-+-+-+-+-+-+