----------------------------------------
|   |             |     |             | |
|-+ +-+ + +-+-+-+ + + +-+ +-+-+-+-+ + + +
| | |   |   |   | | |       |       |   |
| + + + +-+ +-+ + +-+ +-+-+ + +-+-+-+-+ +
|   | |   | |   |   | |   | |   |     | |
| + + +-+ + + + +-+ +-+ + +-+-+ + +-+-+ +
| | | |   | | |   | |   |       | |   | |
|-+ +-+ +-+ + +-+-+ + +-+-+-+-+-+ + + + +
|         | |     | |   | |         |   |
|-+-+ +-+-+ +-+-+ + +-+ + + +-+-+-+ +-+-+
|     |   |     |     | |     |   |     |
| +-+-+ + +-+-+ +-+-+ + + +-+-+ + +-+-+-+
| |   | |     |     |   | | |   |       |
| + + + +-+-+ + +-+ +-+-+ + + +-+-+-+-+ +
|   |     | | |   |   |     |       |   |
| +-+ +-+-+ + +-+-+-+ +-+-+-+-+-+-+ + +-+
| | | |     |         |     |   |   |   |
|-+ + +-+-+ +-+-+-+-+-+ + + +-+ + +-+-+ +
|                       | |   | |     | |
|-+ + +-+ + +-+-+-+-+-+-+ + +-+ + +-+ + +
|   |   | | | |   | | |   |   | | |   | |
| +-+ +-+-+-+ +-+ + + + + +-+ + +-+ +-+ +
|   | |             |     |   | |   |   |
| +-+-+-+ +-+ + + + + +-+-+ + + + +-+ +-+
|   |   | | | | | |   |   | | |     |   |
|-+ + +-+ + + +-+-+ +-+-+ +-+ +-+-+ +-+ +
|     |   |     |       | |       | |   |
|-+ +-+ +-+ +-+-+-+ +-+ + +-+-+-+ + +-+ +
|   |   | | |     | |       |   | |   | |
| + +-+-+ + + + + +-+-+ +-+ + + + +-+-+ +
|     | |     | |   | |       | | |   | |
|-+ + + + + +-+-+ +-+ +-+-+-+-+-+ + + + +
|       | | |       |     |         |   |
|-+-+-+-+ + +-+-+ + + +-+ +-+-+ +-+-+-+ +
|       |   | |   |   | | |   | |       |
| +-+-+-+ + + + + +-+ + +-+ + +-+ +-+-+-+
|     |       | |   |     |   |       | |
|-+ + + + +-+ +-+-+-+-+ + + + +-+-+-+-+ +
|   |   |       |           |           |
|-+-+-+-+-+-+-+-+-+-+-+-+-+-+-+-+-+-+-+-+