----------------------------------------
|   |     |       |     |               |
| + +-+-+ + +-+-+-+ +-+ +-+-+ +-+-+-+-+ +
| |     |   |       | |       |       | |
| +-+ + + +-+ + +-+-+ +-+-+-+-+ +-+-+ + +
| |       | | |     |             |   | |
|-+-+-+-+ + + +-+-+ + +-+-+-+-+-+-+ + + +
|     | | |     |   |       | | |   | | |
|-+ +-+ + +-+-+-+ +-+-+ +-+ + + + +-+ + +
| | |   | |   |   |   |   | |   | |   | |
| + +-+ + + + + +-+ + +-+ + + + + +-+-+ +
|     |   | | |   | |   | | | | |       |
| +-+ + +-+ + +-+ + + +-+ +-+ + +-+-+-+ +
|   |   |   |   | | |     |     | | |   |
|-+ +-+-+ +-+-+ + +-+-+ +-+-+ +-+ + +-+ +
|   |       |   |     |         |       |
| +-+-+-+-+ + + +-+-+ + +-+-+ +-+-+-+ + +
|   |   |   | |       |   | | |     |   |
| +-+ + +-+ +-+-+-+-+-+ +-+ + + +-+ + +-+
| |   | |   |   |           |   |   | | |
| + +-+ + +-+ + +-+ +-+-+-+-+ +-+ +-+ + +
|   |   | |   | |       |       | | | | |
|-+-+ +-+ + + +-+ +-+-+-+-+-+-+-+ + +-+ +
|   |   |   | |   | |       |   | |     |
| +-+-+ +-+-+ + +-+ + + +-+ + + +-+ +-+ +
|     |   |   |   |   | | |   |     |   |
|-+ + +-+ + +-+ +-+-+-+ + +-+-+-+-+-+ +-+
|   | |   |   | |     | | |         | | |
| + +-+ +-+ + + + + +-+ + + +-+ +-+ + + +
| | |   | | | |   |     | | | | |   |   |
| +-+ +-+ + + +-+-+ +-+-+ + + + + +-+-+ +
| |   |     | |     |   |     | |     | |
| + +-+ +-+-+ + +-+-+ + +-+-+-+ +-+-+ + +
| |   | |   | | |     |   |     |     | |
| +-+ + + + + +-+ +-+-+-+ + +-+-+-+-+-+ +
|   | | | | |       |   | |   |     |   |
| +-+ +-+ + +-+-+-+ + + + + + + +-+ + +-+
|     |   |   |   | | | | | |   | | | | |
| +-+-+ +-+-+ + + +-+ + + + +-+-+ + + + +
|       |       |     |   |       |     |
|-+-+-+-+-+-+-+-+-+-+-+-+-+-+-+-+-+-+-+-+